buffet : vt.连续猛击;打来打去n.自助餐
cloth : n.(一类)布;织物;布料
edge : n.边缘;边线;刀刃vt.&vi.(使)徐徐移动;给......加边
valley : n.谷;山谷;溪谷
vast : adj.辽阔的;巨大的;庞大的
glacier : n.冰川
reindeer : n.驯鹿
territory : n.领土;版图;领域;地盘
ban : vt.明令禁止;取缔n.禁令
boundary : n.边界;界限;分界线
cottage : n.小屋;(尤指)村舍;小别墅
visible : adj.看得见的;可见的
on the move : 在行进中;在移动中
accompany : vt.陪同;陪伴;伴随;(尤指用钢琴)为......伴奏
adopt : vt.采用;采取;采纳vt.&vi.领养
sour : adj.酸的;有酸味的
set out : 出发;启程;(怀着目标)开始工作
bless : vt.祝福
live off : 依靠......生活;以吃......为生
prohibition : n.禁止;阻止;禁令
prohibit : vt.(尤指以法令)禁止;阻止
journalist : n.新闻记者;新闻工作者
sneeze : vi.打喷嚏n.喷嚏;喷嚏声
teapot : n.茶壶
label : vt.用标签标明;贴标签于n.标签;标记
cream : n.奶油;乳脂;护肤霜adj.奶油色的;淡黄色的
leopard : n.豹
stretch : vt.延伸;延续vt.&vi.伸展;舒展
rewarding : adj.值得做的;有益的
bush : n.灌木
lung : n.肺
cycle : n.自行车;摩托车;循环vi.骑自行车
corridor : n.走廊
pedal : n.(自行车等的)脚蹬子;踏板vt.&vi.骑自行车;踩踏板
fountain : n.喷泉;人工喷泉;喷水池
route : n.路线;路途;途径
ahead : adv.向前;在前面;提前
theme : n.主题;主 旋律
theme park : n.主题公园;主题乐园
roller coaster : n.过山车
incredible : adj.难以置信的;极好的;极大的
appeal : vi.有吸引力;呼吁;恳求;上诉n.吸引力;呼吁;上诉;请求
appeal to : 有吸引力;有感染力;呼吁;上诉;打动
pirate : n.海盗;盗版者vt.盗印;盗用
adorable : adj.可爱的;讨人喜爱的
wander : vi.漫游;闲逛;游荡;徘徊;流浪vt.走过;漫步于n.漫游;闲逛
amuse : vt.(提供)娱乐,逗乐
enormous : adj.巨大的;极大的;庞大的
swing : vi.&vt.(使)摇摆;(使)摆动n.摇摆;摆动
iron : n.铁;烙铁;熨斗vt.&vi.(用熨斗)熨平
fashion : n.(妇女的)时装;流行款式
rare : adj.稀有的;罕见的;(肉)半熟的
steam : n.水蒸气;蒸汽;蒸汽动力vi.蒸发;散发蒸汽;冒水汽
superb : adj.极好的;卓越的;质量高的
aquarium : n.水族馆;水族玻璃缸;养鱼缸
up to : 达到(某数量、程度等);直到;不多于;(体力或智力上)能胜任
polar : adj.(地)极的;南極(或北极)的;磁极的
upside down : adv.颠倒;倒转;翻转
splendid : adj.极好的;壮丽的;辉煌的;极佳的
display : vt.展览;陈列;展示n.展览;陈列品
appetite : n.食欲;胃口;强烈欲望
entertainment : n.娱乐;招待;娱乐活动;文娱节目
column : n.(书、报纸印刷页上的)栏;专栏;柱(形物)