cuisine : n. 菜肴; 风味; 烹饪
prior : adj. 先前的; 优先的
prior to : 在……之前的
consist : vi.由……组成
consist of : 由……组成 ( 或构成 )
pepper : n. 甜椒; 灯笼椒; 胡椒粉
recipe : n. 烹饪法; 食谱
bold : adj. 大胆自信的; 敢于冒险的
chef : n. 厨师; 主厨
peppercorn : n. 胡椒粒
vinegar : n. 醋
stuff : vt. 填满; 把……塞进 n. 东西; 物品
slice : n. ( 竹下的食物 ) 薄片 vt. 把……切成薄片
slice off : 切下
onion : n. 洋葱; 葱头
lamb : n. 羔羊; 羔羊肉
lamb kebab : n. 烤羊肉串
elegant : adj. 精美的; 讲究的; 大方的
dim sum : n. 点心 ( 中国食品 )
exceptional : adj. 特别的; 罕见的
minimum : n. 最小值; 最少量 adj. 最低 ( 限度 ) 的; 最小的
consume : vt. 吃; 喝; 饮
temper : n. 脾气; 火气; 怒气
vegetarian : n. 素食者
junk : n. 废旧物品; 垃圾
junk food : 垃圾食品
garlic : n. 大蒜
bacon : n. 咸猪肉; 培根
ham : n. 火腿
sausage : n. 香肠; 腊肠
cabbage : n. 甘蓝; 卷心菜; 洋白菜
bean curd : n. 豆腐
brand : n. 商标; 牌子
olive : n. 橄榄; 橄榄树
fig : n. 无花果
ingredient : n. ( 尤指烹饪 ) 材料; 成分
dessert : n. ( 饭后 ) 甜食
dough : n. 生面团
stable : adj. 稳定的; 稳固的
haggis : n. 哈吉斯 ( 苏格兰特殊食品 )
canteen : n. 食堂; 餐厅
cafeteria : n. 自助餐厅
bun : n. 小圆面包; 小圆甜蛋糕
chilli : n. [pl. -es] 辣椒
pork : n. 猪肉
red braised : adj. 红烧的
pearl : n. 珍珠
somewhat : adv. 有点; 有些; 相当
madam : n. ( 对妇女的尊称 ) 女士; 夫人
calorie : n. 卡路里 ( 热量单位 )
association : n. 协会; 社团; 节会; 关联
regardless : adv. 不顾; 不理会
regardless of : 不管; 不顾
category : n. 类别; 种类
vitamin : n. 维生素; 维他命
fibre : n. 纤维; 纤维制品
quantity : n. 数量; 数额
dairy : adj. 奶制的; 乳品的 n. 乳品厂; 乳品公司
moderation : n. 适度; 适中; 合理
ideal : adj. 完美的; 理想的; 想象的 n. 理想; 完美的典型
fundamental : adj. 根本的; 基本的; 基础的
chew : vt. & vi. 咀嚼; 嚼碎
consistent : adj. 一致的; 连续的
modest : adj. 谦虚的; 适度的; 中等的
trick : n. 诀窍; 技巧; 招数
overall : adj. 总体的; 全面的
