airline : n. 航空公司
bay : n. (海或湖的) 湾
craft : n. 手艺; 工艺; 技艺
antique : n. 古物; 古董 adj. 古老的; 古董的
pleasant : adj. 令人愉快的; 友好的
arise : vi. (arose, arisen) 起身; 出现; 自……引起
massive : adj. 巨大的; 非常严重的
literally : adv. 字面上; 真正地
breath : n. 呼吸的空气
take sb's breath away : 令人惊叹
bound : adj. 准备前往 (某地); 一定会
scenery : n. 风景; 景色
awesome : adj. 令人惊叹的; 可怕的; 极好的
spectacular : adj. 壮观的; 壮丽的; 惊人的 n. 壮丽的场面; 精彩的表演
peak : n. 顶峰; 山峰; 尖形
highlight : n. 最好或最精彩的部分 vt. 突出; 强调; 使醒目
goat : n. 山羊
grizzly bear : n. 灰熊
drill : vi. & vt. 钻(孔); 打(眼) n. 钻(头); 训练; 练习
freezing : adj. 极冷的; 冰冻的
freezing cold : 极冷的; 凛冽的
freeze : vi. & vt. (froze, frozen) 结冰; (使) 冻住
mall : n. (also shopping mall) 购物商场; 购物广场
prairie : n. 北美大草原
anticipate : vt. 预料; 预见; 期望
bunch : n. 束; 串; 捆
a bunch of : 一束; 一串; 一群; 大量
thunder : vi. 打雷; 轰隆隆地响; 轰隆隆地快速移动 n. 雷声; 轰隆声
frost : n. 霜; 严寒天气; 霜冻 vt. 使蒙上霜 vi. 结霜
curtain : n. 窗帘
border : n. 国界; 边界 (地区)
duration : n. 持续时间; 期间
harbour : (especially US harbor) n. (海) 港; 港口
enrol : (especially US enroll) vi. & vt. (使) 加入; 注册; 登记
quarry : n. 采石场
idiom : n. 习语; 成语
contrary : adj. 相反的; 相对立的 n. 相反的事实 (或事物)
contrary to : 相反的; 相对立的
anyhow : adv. (结束交谈或转换话题时) 不过; 反正
alongside : prep. 在……旁边; 与……一起 adv. 在旁边
proceed : vi. 行进; 继续做
proceed to sth : 进而做 (参加)
shore : n. 岸; 滨
astonish : vt. 使十分惊讶; 使吃惊
misty : adj. 多雾的; 模糊的
mist : n. 薄雾; 水汽
steel : n. 钢; 钢铁工业
dusk : n. 黄昏; 傍晚
advertisement : (informal ad) n. 广告; 启事
accent : n. 口音
photographer : n. 摄影师; 拍照者
owe : vt. 欠 (账、债、情等)
owe sth to sb : 欠 (某人情); 把……归功于某人
toast : n. 烤面包片; 吐司; 干杯 vt. 为……干杯 vt. & vi. 烤 (尤指面包)
cobblestone : adj. 铺有鹅卵石的
coherent : adj. 有条理的; 清楚易懂的